1111111111111
10E00C0001001
1000000000001
10001P0011111
1000110000C01
1111111111111
