111111111111111111
1P0000000000000001
10010000100C110001
1001C0001000000001
10011000000000C101
1000100001100C1C01
1000C100100100C101
100001001001001001
100000001C00100001
1000000010000000E1
111111111111111111
